6 7
1 1
3 5
XXXXXXX
XS5126X
X1X1X2X
X2XXXGX
X32421X
XXXXXXX

