149 101
103 32
138 61
XXXXXXXXXXXXXXXXXXXXXXXXXXXXXXXXXXXXXXXXXXXXXXXXXXXXXXXXXXXXXXXXXXXXXXXXXXXXXXXXXXXXXXXXXXXXXXXXXXXXX
X663774345X69431X813542564X786X4371564872716X87786X45894576283X884X84642X47776X7X438X629X772X58342X4X
X9X5X6X3X3X1X2X9XXXXXXXXX4X5XXXXX4X1XXXXX1XXX7XXXXXXXXXXX8XXXX94X5XXX5X2XX22X4X6X8XXXXX6XXX9XXX6X5X6X
X2X9X5X4X9X7X6X799X3X384X12992X137X546X9377194X466X8X64926555725X3X6X5X74479X776X582X93392X91199X821X
XXXXXXXXX4XXXXX9XXX9X6XXXXXXX1X9X5XXXXX3XXXXX1X7X2X8XXX7XXXXX7XXXXX4X3XXX5XXXXX7XXX9X8X4XXX26XX9X3X3X
X5551417697566X3X6X2X777971445X5X773X284X66868X2X739589857X8X4X887X92972X355X813X18885X1X46763X5X6X1X
XXX8X9XXX4XXXXX1X5X6X9X4X3XXX8XXX4XXX2X3XXX2XXXXXXX9X7XXXXX9XXX3XXX5X6X8XXXXXXXXXXXXX6X8X4XXX7XXXXX7X
X612X9X9X5X2X452X882X9X5X736X9X7X553X1X378X1X1193794X96118845994X6X1X2X8X947X2X773X412X851X958X7X269X
X9X5XXX2XXX4X6X7XXX1X6XXXXXXXXX6X5XXX4XXXXX9X4X2XXX2XXXXX9XXXXXXX4X1XXXXX3XXX8X5X5X5X9XXXXX1XXX1X9XXX
X9X363X9455867X918X898X952X3135669X9X49558X1X5X9X6X2X11411X72353X3X89533786361X3X868X4X371X375X7X124X
XXX4X2XXXXXXX4X4XXX5XXXXX2X9XXXXX6X2XXXXXXX5XXXXX8X4XXXXX9X2X8XXX8X4XXXXXXXXX4XXXXX2X4XXX6X3X7X9XXX1X
X6X7X31648X896X8X934X864X798X82531X3X986X5X98926X4955458X6X7X463X814X26249X8X9X7X853X53888X1X752X4X6X
X7X1X6XXX3X9XXXXX9X2X5X4XXXXX4XXX1X5X9XXX4X1XXXXXXX8XXX9XXXXX5XXX4XXXXX6XXX6X1X3XXXXXXXXXXX6XXXXX8X3X
X442X352X72757X599X1X3X1X813X6X837X915X364X6621372X9X8684434X5641917598612X8356927X1X2851621X4X53934X
X2XXXXXXX4XXX5XXX4XXXXX8XXX3XXX3XXXXX5X3X7XXX1XXXXXXXXXXX1XXX6X7X1XXXXX8X1XXX8XXXXX2X9XXX3XXX1XXX6X9X
X32113X344X64944X56753X9644672X8X5713573X685X772863667X7271834X7X421X464X1X72336X3961751X87694X962X1X
X1XXX7X4XXXXXXX8X9X8X8XXXXXXX5XXX4X3XXX1XXXXXXXXX8XXXXX3XXX2XXX5XXXXXXXXXXXXXXXXX7XXX6XXXXX2X2XXXXX7X
X5X6X3X3X7X866X3X5X7X746X56921X4X9X516X53779X8X6X6X6X444X471X85425X8787347X541X9X9X285885825X3X74762X
XXX2X4XXX6XXX4X6X2XXXXXXX5X4X7X4X8XXXXXXXXX9X5X8X4X8X2XXXXX1XXXXXXX7X5XXXXX1X2X8X7XXXXXXX6X5XXXXX5X6X
X7X782898133X32417X5X1X623X7X4X984X4X2973978X3431273381278X9X1X4X7X1X673X382X819496525X2X2X3X7X219X9X
X2X3X3X5X2XXXXXXXXX2X6XXX6XXXXXXXXX7X1XXX1XXX3XXX5XXXXXXXXX2X1X1X6XXXXX4X9XXX4XXX2X4X6X9XXXXX7XXX2XXX
X565X5X5X1X1212619X7X665182579X26728X2X65354X725X9355426X4X26967X1149658X363X8X463X9X8X879X9X9X2X6X9X
XXX4X6XXX2X2XXXXXXX2X2XXXXXXXXX5XXX1X5XXXXX7X6X8X9XXXXX9X2X7XXX4X6X8XXXXX9XXX3XXXXXXXXXXX8X6X6X6XXX2X
X179X249X2X8854124X328X2X973X13188X3X868X9X3X6X5X1X228X5X941X58727X8X4X1X1X1632197X46198371169X86427X
XXX9X7XXXXX7XXX3XXX1X3X5X8XXXXX5X1X3X5XXX9X2X4XXXXX6XXXXX1XXXXXXXXX8X2X2XXX6XXXXX8X3XXXXX3XXXXX7X2XXX
X2X5X2142418X1826484X8X5161232X5X7X787X413X7966485X374X942X7765663522352875728X273141539X351X823X6X8X
X4XXXXXXX2XXXXX6X1XXXXXXXXX5XXXXXXXXXXX7XXX5X7XXX6X3XXXXXXX3X8X2X5XXXXXXX3X6X6XXXXX2X9X6XXXXXXX1XXX2X
X371X2X5X7X61428X115X1994589X2X739X2X7X483X6X5X2932661X3X527X7X6X41696X946X8X5X4X2X1X6X829519112X421X
X6X1X5X9X1XXXXXXX6X2XXXXXXX3X3XXX4X5X3X2XXX7XXXXXXX8XXX6X8X6X9XXXXXXXXXXX2XXX5X5X6XXXXX5XXXXXXXXX4XXX
X9X8X3X275X966X783X91529774237X2X4X138693345X478X346X9X933X661X2X2X4X7393121X6X7X462X31448X855528882X
X1XXX8XXX5X6X4X7X3XXXXXXXXX3X9X1X6X3XXX2X6XXX8XXXXX5X2XXXXXXXXX7X8X4XXXXX8XXX2X4XXX6XXX6XXX4XXX7X6XXX
X458613257X9X3X2X658X997X173X95726X2X6X6X329X69876X897X6X6X3X13188X8X56513X893X56575X841X2X456X4X2X5X
XXX4X1XXXXXXX3XXX6XXX7XXX5X1XXX2XXXXX9X5X2XXX2XXX3XXX1X7X5X9XXXXX9X5XXXXX4XXX5X4XXX9XXXXX8X1XXXXX5X3X
X321X261X3X1X3X414X84939X5X925X36976X7X1X553X5X296X8X5X1X3554916X6X5X8X2X845X58384X4X2X226X73317X886X
XXX6X2XXX6X3X7X2XXXXX9XXX7X7XXX6X1X3X9X9X4XXX6XXX4X7XXX5X2XXXXXXX3X5X1X5X6X7X3X9X2XXX2X2XXXXX5X3X5XXX
X267X9X552X3959523X96186X7X474X8X6X713X5X196X8X2X8919919X96142X434X9X8X9X8X2X2X3X58137633627X8X4X993X
X7X1XXX1X9X2X9XXX4X5XXX8X2XXXXX6X7XXX6X4XXXXX9X7XXXXX5XXX2XXX1XXX1X5X8X3XXX1X6XXX4XXX1XXX7XXXXXXX7X9X
X9X77412X1X1X1X8X4X218X7X714X2X1X8X3X2X7X952155114X4575154X127X9184224254261X897X2X43382X1X917X185X5X
XXX5XXXXXXXXX2X3X4XXX5XXX8XXX6XXXXX9X5XXXXXXXXXXXXX6XXXXX2XXXXX5X4XXXXX3XXX7X5XXX8XXXXXXX9X9X6X4X2XXX
X81629X4985653X555X664X158X277X9X878392854X9X9X52675X514332838X7X27156X6X383X6X568X52111X785X1X4X399X
X8X8X6XXXXX3XXXXXXXXX8XXX1X3XXX4X3X7X2X8XXX8X1XXXXX8X5X2XXX5XXXXXXXXXXX5X2XXXXX7XXXXXXX7XXX8X7XXX5XXX
X4X8X9X628X79769X476X712X926X72582X8X5X812X4X2X996X8X2X648X695X636X4X7X7X75165X4X7X972X3X612X35447X3X
XXX5XXX6X3X3XXX4X8X8XXX7XXX5XXXXXXXXXXXXX7X5X7XXX2X2XXX8XXX3XXX6XXX5X9X8XXXXX4XXX5XXX3X9XXX6XXX4XXX4X
X3X337X5X362X729X2X2X27149659445X359X969X1X861929126X3X2X73123X6459553X567X747247776X1X67827X7455638X
X8XXXXXXX5XXXXX6X2X4X9XXXXXXX5XXX6XXXXX4XXX5XXXXX1XXX1XXX4XXX5XXXXX4XXX5XXX9X1XXXXX3X5XXX8X9X1X7X3X3X
X3546187X5X7X879X1X39515X62647X4X5X1X775X7X345X997X791X6X5X6X3X593X2679557X7X52672X9X578X2X4X1X4X4X4X
XXX9X1XXX5X6XXXXXXXXX5XXX7XXXXX6X3X4X4X6X9X2XXXXX7XXX7X1X9X5XXX8X2X6X5XXX9XXX6XXX2XXXXX1X8XXXXXXX6X7X
X228X691517139X3X8X942X6X1X9X41956X998X8621159X5313669X2218183X8X923X733X8X242X6X4X4812957X13199X6X4X
X3XXX6X2XXX9X7X8X5XXX9X8XXX2X2XXX2XXX7X3X4XXXXX3XXXXXXXXX8XXXXXXXXX1X2XXXXXXX6X1XXXXXXX4XXX6XXX9X1XXX
X526X7X8X9X3X474X244X8X25881X432X28157X5X5X5638316566346X251X612X6X1X157X67391X36347318529X4X6X317X9X
X2XXX4XXX2X6XXX1X7XXX7X8X6X8XXXXXXX3XXX1XXXXXXX4X4XXXXXXXXX6XXX6X4X1XXXXXXXXXXXXX7XXXXXXXXX1X8X9XXX9X
X963X622X48354X442X33811X5X656332663X7X2X7X217X3X123X534X627X944X1X63926X4752717X35791X766X4X1X18188X
X6X2XXXXX9X5X3XXX2XXX6XXX3XXXXX6XXX2X5X9X1X8X8XXXXXXX1X4XXX8XXX1X9X4XXXXX1XXXXXXXXX1XXXXX3XXX9XXX5X5X
X6X797X497X2X723X4X229X98295X1X676X8X37965X1X887X17164X4X2X7X51343328683X9X28447X38286X4X33846X4X7X4X
XXX2XXXXX3XXXXXXXXXXXXX9XXX6X3XXXXXXX7X1XXX9X6XXXXX5XXXXX1X2XXX3X1X1XXX8X6X3XXX9XXXXXXX2XXX7XXX2XXX1X
X3X33623X8X695539324X38731X179X62661X9X338X1X753636694286286X5X1X9X8X327X2X5X97343833264X316461216X6X
X2XXX3X1XXX7XXXXX5XXXXX8XXXXXXX4XXX91XXXXXX5X7X7X6XXX9X2XXX5X9XXXXX6XXXXX1X7XXXXX4XXXXXXXXX2XXX9XXXXX
X41175X3X4X9X895X8X8271939X6X3X7X382X9X26624X7X3X3X886X5X231X3X7376471X5X485X6X92951X5367895X16515X5X
XXX1XXX6X2X1X9X1XXX5XXX8XXX9X7X8XXX2X4XXXXXXX5XXX5XXXXX6XXX6X6XXX7XXXXX5XXXXX9XXX3X3X1XXX2XXXXXXX5X1X
X47392X1X4X479X822X938X89699X713X78342X5X55811X9X1X9X964X415145474399488X7217584X6X668X28351X5X66145X
X2XXXXXXX6X4XXX1X8X8X4X7XXX6X2XXX5XXX5X9XXX4XXX1X4X1XXXXX3X3X7XXXXXXXXXXX2XXX8XXXXX3X7XXXXX7X3XXX9XXX
X372223758X125X2X874X1X2X1178356X3X369X13783X178X595X1X965X5X3X677X9X2X78173X2778233X633X444X279X748X
X4X5X3XXXXXXX6XXX2X4XXXXX5X3X1X3XXXXX4XXX3X5X5XXXXXXX1XXXXX3X4X7X7X7X7XXX1X4XXXXXXX9XXXXXXX5X9XXXXX9X
X1X3X5X179X6X2X497X6X48167X2X9X515X51358X3X856935872X89895X5X578X6X3X2X7X4X6733138X853X1X63834X5X235X
X8XXX7X7X5X8XXX2XXXXXXXXX5XXX7XXXXXXX6X6X1XXXXXXXXX3X6XXXXX4X7X4XXX8X1X6X7XXXXXXXXXXXXX1X9XXX5X7X4X7X
X5X5X749X2X6X6118151X41991X6X142X49414X927X1X9X8X6X83982X1X8X3X25337276751559186X2X8X38139X51535X4X1X
X6X7XXX1XXX5X6XXXXXXXXX8XXX4X5XXXXX3XXX5XXX5X5X1X8X8X4XXX4X2XXX3XXX5XXXXXXXXX9X4X7X2XXX8XXXXXXXXXXX8X
X649X98417X5X92257X2X883X649X2X818X828X977X6X11586X1X8X4X791X96449X45228X42646X675X83219X72766X5X831X
XXXXXXXXX1X4X8XXXXX1XXX5XXX5X4X6XXXXXXX4X3X8X5X3XXX5XXX4X8XXX7X4X7XXX8XXXXXXX6X7X7X3XXX3X9X4X1X2XXX2X
X565X9X557X621597228X658X9X9X78353X19669X94916X1X953X7X728X659X6X3X4X2X384X395X4X4X7X7X343X5X5X79378X
X7XXX5XXX4X8XXX6X3XXX2X2X5X3X7XXXXXXXXX4X4XXX6X4XXXXX1X6X5XXXXXXXXX2X5X1X7X9X9X3XXXXX2X5XXX4X7XXXXX4X
X3X5673163X395X3X243X1X65155X681X2525833X872X1X914X8X4X2X3X2134953X13675X3X7X6X438X7X993X9X9X398X315X
X4X4X4X9XXX1X4XXXXXXXXXXX2XXX5XXX1XXXXXXXXX7XXXXXXX7X6X9XXX8X4X1XXXXX2X4XXXXX4X8XXX8XXX5X2XXXXXXXXXXX
X8X1X7X483X5X255X8X16186X8X9X3X7X5X2X5522216X986X9X9293696X9X4X115X617X95697X1X8X21459X9X283X7977878X
X7X7XXX3X2XXX8XXX3XXXXX8XXX3XXX6X3X8XXX5XXX4X6XXX5XXX8X9X7X8X6XXX4X5XXXXX6X6XXX6X1XXX8X6XXX6XXX5XXXXX
X755X511X6X3564238X1X2279138X5X637X53539X789X6699714X1X5X7X5X2X721948278X6X5X7X3X131X3X896179767X975X
X9X1X16XXXXXX3XXXXX4X4X6XXX3X8XXX5XXXXX8XXX1X2X8XXXXXXX6XXXXX6XXXXX4X8X4XXX1X2X1X5X5X5X2X4X3X5XXXXX8X
X1X1X516X217X2X768X9X1X661X344497721X25292X335X92475X49431X564X253X6X9X2X4X7X312X9X7X231X8X3X9958345X
X4X8X2XXX7X3X2XXX1X2X3X1X2X7X3XXX8XXXXXXXXX5X4XXX3X1X4XXXXX1XXXXX2XXXXX7X9XXXXXXX8XXX3XXXXXXX3XXXXX4X
X1X2X64837X5X5X7375949X2X2X6X6X6X9X633X9X7X2X832X2X9X6X752X9X9X921X945878736X824X882X3X23411X4X54636X
X6XXX3X9XXXXX6XXXXXXXXX1XXX9XXX7XXXXX6X6X3XXXXXXXXXXXXX4X7X7X2X5XXX5X4XXXXXXX1XXXXXXX5XXXXX5X5XXXXX6X
X6X6X1X1X973X5X39499915638X274X1X474977326X8X921X4933395X5X9X217X181X6X98311X233132415X4X368288576X6X
X9X1X3XXXXX7XXXXXXX3XXX8X8XXXXX1XXX6XXXXX2X4X8X5XXXXX4XXXXXXX5XXX4XXX2XXX2XXX5X1X9X5XXX3X7XXXXX6X2XXX
X6X6X9X363X1X25474X292X2X5X983X9X7X956X198X2X1X4X953X6X96164X835X596X97963X545X8X8X899X174X65824X928X
XXX6XXX5XXX5XXXXX4X5XXXXX7X4X4X8X7XXX3XXX1X4X4X5X4X2X9X1XXXXX7XXXXX3X6XXXXX6XXX6XXXXX2XXXXXXXXXXXXX7X
X1X154X59957X5X838X8X9X718X2X9371717X221X1X2X7X217X673X5X36295X551X9X419X934X856X38188X27948645877X3X
X6XXX2X4XXX1X8X5X7X2X7XXXXXXX3XXX6XXX4XXXXX2XXX6XXXXX3X2XXX7X3XXX4X7XXXXXXXXXXX1XXX3XXXXX5X3XXXXXXX5X
X8X97423X274X8X4X3X931X953X47337X3X591X2814678842487X55524X9X956X15594X9X597X2X3X4X665X759X254X4X6X6X
X9X8X3XXXXX6X3X9X2X7XXXXX6X8X2X3XXXXX4X4X5XXXXXXXXXXX8XXXXXXX7XXXXX4X7X2XXX9X4X6X9XXXXXXX4XXXXX1X8X7X
X187X5X6X4394983X221X1733579X4X417X518X7X8X2X16223X8885224299481X9X6X8X7X632X1X63323X4X217X841X379X1X
X3X2XXX9X7XXXXXXX9XXXXXXXXX6XXXXXXX4X2XXX4X4XXXXX7XXXXX4XXXXX1X3X5XXX6X8X2XXX8X4XXXXX8X9X8X6X6X9XXXXX
X4X9X6X5883641X95991X229X942X19154X5X6X612X254992428X696X288X4X748X581X65786X5965639X752X328X893X2X7X
X4XXX7X9XXXXX2XXXXX6XXX8XXX7X1XXXXX8X3X4XXX7XXXXXXX1X7X7XXX4XXXXXXX8XXXXX1XXXXX8XXXXX2XXXXX2XXX8X4X5X
X8X33226X689X918X6X8X24467252184X783X16895X9X5X7X146X9X3787189X557173323X429X215X9557612X2X8X9899536X
XXXXX2X5X4XXXXX3X8XXXXXXX3XXXXXXX5XXX3XXXXX6X8X9XXX3XXXXXXX7XXX2X6X2XXX2XXX1X8XXX9XXXXX1X9X1XXX5XXX7X
X89785X4X221X696X3359888555132X127X31293X61712X77912591851685827X2X3X561X177843135X9298853X6X9X8X7X8X
X7X5X2X6X2X3X1XXXXXXX7X1XXX7X4XXX9XXX8XXXXX3X5XXXXX5XXX6X1X5X7XXX3XXX4XXXXXXXXX3XXXXXXXXX1XXX8X4X4X1X
X9X9X3X5X5X7X8X13185X1X3X577X991X656X9X827X2X244X2X757X8X5X4X974X4X7989797X357X9X6X866X2853921X684X9X
XXXXXXX3XXX3XXX2X8XXXXX6XXX5X9XXXXX3XXXXX3XXXXXXX1X6XXXXXXX4X7XXXXX5X3XXXXX3XXXXX6X8XXX1X9XXXXX7XXXXX
X9X5X59835294843X6X762X127X5X929616638X2X347782998X5X76973X4X2X383X8X541537125X8X1689622X74482X3X9X7X
X4X8X2XXXXX9XXX9XXX8XXX9XXXXX5X1X8X1XXX3XXXXX6XXX4XXX9XXXXX1XXX2X4X7X2XXX8XXX9X5X7X1XXX2X3XXX9XXX2X6X
X336X6X86689X73994X1X64765X299X1X4X415X4592372X28526678235X34246X6X5X3X49481X8X178X752X5X794X4X1X732X
X8XXX6X5XXXXX3X3XXX7XXX2XXXXXXXXXXXXXXX1XXXXX7X1X7XXXXXXX9X1X3X5XXXXX6XXXXXXXXXXX4X7X1XXXXXXX7X3X4XXX
X55854X5X1X7X8X43327X46411225999S9X936X6X5X8X9X9X58523X4X625X9X57486X421X1X186X1X4X7X565X6X263X49425X
X7XXXXX7X7X7X7XXX6XXX3XXX4X1X3XXXXXXX1X9X3X8X6XXXXX9X3X1XXX4X7XXX6XXX3X3X7X9XXX8XXXXX7X5X1XXX3XXX4XXX
X896X386X312X729X535X527X9X9X9X564X254X643X653X2X5X1X6X944X4X6X91393X7X3X96185X376X2X6X225X9X6X69772X
XXXXXXX7X2XXX5XXXXXXXXXXX5XXXXX6XXXXX9XXX3X6X5X3X5X1X2X3XXXXXXXXX6X6XXXXXXX5XXX6XXX7XXXXXX58X6X7XXX1X
X596X1X24324X8X495X914937923X69588X2995361X4X1X44515X4X1X3X434X729X794444237X8X881434848X2633391X239X
X7XXX7XXXXX9XXX6X1XXXXX8X5XXXXX3XXXXXXX4X6XXXXX9XXXXX8X5X9X2XXXXX2XXX7XXX8X7X1XXXXX3XXXXXXXXX2XXXXX5X
X2X966X8X8X99357X6X157X7X9X256X1X2X77846X14492X142X775X6X4X948X335X17722X8X4X673973811X2X742X2X965X2X
X8X8X8X2X7XXX4XXXXXXX2XXX6XXX9X2X6XXXXXXX9XXX6XXX6X4X8X4X5X8XXX3XXXXX4X1XXXXX1XXXXXXX1X7XXX5X1X4XXXXX
X653X7X924499717X21786436717X4X4X2X1415832X788X219X3X123X1X5X341X442X3X327X1X462X983X373X81126356414X
X7XXXXXXXXXXXXX8X7XXX7XXXXX7X1X9X7XXX9X5XXXXXXXXX6XXXXXXX9X9XXXXX7XXXXX4XXX1X8XXX4XXX6XXXXX2XXXXXXXXX
X822687611361236X1X8X5X1512573X78253X3X1873185X422X582X3X8748248353174X543X91637X6X7356714357976X5X5X
X3XXXXXXXXXXX1X6XXX3XXX4XXXXXXX5X9X1XXXXX7XXXXXXXXXXX9X4XXXXX7XXX7XXXXXXX5X2X9XXX7XXXXXXX5X8XXX2X6X4X
X2X57975X645X1X887X83978829369X6X6X9X656X84467814489X915415378X3X9X5X2X738X6X9X336X4X381X8X5X8833983X
X3X9X8X1X4XXX1XXX1X8X6X4XXX9XXXXX6XXXXX6XXXXX1X3XXX5XXX9X7XXXXX2X6X4X6X7X8XXX6X1XXX5XXX5X4XXXXXXX3X5X
X5X3X8X4699225X796X2X9X5X5X692X4X7153373X13979X4X763X9X9X189X352X2964814X9X532X4X439X121X45215X613X1X
X3X1X4XXXXX1XXX8X6X1X2XXX4X6X4X3X9X3XXX7XXX8XXXXXXX7X3XXXXX6X9X8XXXXXXXXXXX9XXX6X5XXXXX3XXX5X3XXXXXXX
X8X9X539X62495X5X5X1X8X22449X4X2X9X848X837X56796X217X9X281X9X2X779X6X253114228X986X21714X4X3X3X6X1X4X
XXXXXXX3XXX1X4XXXXX6XXXXX6XXXXX7X3XXXXX2X9XXXXX1X1XXX4XXX5XXX2X7XXX5X3X6XXXXX4X8XXX5XXXXX4XXX5X5X2X9X
X9X885X5X4X1X382X3298767X4X753X8214932X7X8541156X641X3X238X3X9X2635398X4X555X8X6X47237X285X58681X499X
X9XXX9XXX9X2X1XXX9X1XXX1XXX5XXX2XXXXX2XXX8X1XXX2XXXXX5XXX4X7X9XXXXXXXXX4XXX8XXX4XXX8XXXXX1XXXXXXX3XXX
X474X6X55256X6X3X4X5X6X8X1X1345488X933X895X513X884X121X912X742X4X52341X32548X3X378X2X1X1326591138531X
X5X7X3XXX6X3XXX3XXXXX7XXX7X1XXXXX5XXX5XXXXXXXXX8XXXXX6XXX9XXX1X5X6X9XXXXXXX4X9X7XXX1X5XXX4XXX4X1XXX1X
X9X7218126X49368X57774852528X528X832X3X6X7346412X3242755X3X6X4X1X2X8X14434X74712376614X9X3X636X694X5X
X1XXXXXXXXX5X1XXXXX6XXXXXXX4X1XXX2X5X4X7X5X9XXXXXXX8XXXXX7X9X5X9X1XXX9XXXXX9XXX3XXXXXXX6XXX5X4XXX5XXX
X458X2X11591X3X536X832X854122136X4X6X873X9X23174554842X72956X6X829X6198111X575X487X6X3X852X7X4X26951X
X3XXX7X4XXXXXXX3XXXXXXX9X2XXXXXXXXXXXXX5XXXXXXXXX8XXX6XXX9XXXXX2X9XXXXXXX5XXXXXXX3X3X3X2X5XXXXX5X6X4X
X26234X551X6571348X296X8X2X5X7X383X8X259X5X4818864X184428153X1X7X94862X556X13782251198X1X29726X8X6X7X
XXX9XXXXXXXXXXX6XXXXX8X4X4X5X8X1XXX2XXX9X1X9XXXXX2XXX8XXX9XXX4XXX2XXX6X1X3X4XXX6XXXXX1X1XXX6X3X2XXX4X
X6X183X67479X1955257X463X945X92815X923X9X876X2X741X36989X6831785X5X3X675X27714X8X15439X367X6X57268X6X
X8X9X3X9XXX6X7X4X9XXXXX5XXX3XXX6XXX3XXXXXXX1X1X4X8X3XXX2XXXXX7X9XXX6XXXXX5XXX5XXXXXXX5XXX3XXXXXXXXXXX
X866X311X8X4X5X9X689471582X2X3X99675X5394725X3X2X2X283X192X397X9X857X73411X4X7226894X5244472283834X8X
X6XXXXXXX6XXX1XXX3XXXXXXXXX6X9X3XXXXX1X7XXXXX1X9X7XXXXXXX3X5XXXXXXX3XXX5XXX6X8XXX8X5X4X7XXXXXXX1X8X4X
X253X8173975X3X477766379X174X3X3X794X3X9X1X2X698X638X8X435X7X448X369X9232946X9X687X8X5X52837X673X5X2X
X6XXXXXXX7XXX1X3XXXXX4XXX7XXX2X6XXX1X6XXX6X3XXXXXXXXX8X3X2XXXXX9X7XXX7XXX1X7X7XXXXXXXXXXXXX2X3XXXXX7X
X4X22767X56478X33747X8X522X9292977X31944X6X9246681X4X873X9X854X968937486X3X8X9X8X567X541X526X588X629X
XXX7XXXXX7XXXXXXXXX1X4XXX1XXX7X6XXXXXXXXX7XXXXX1XXX3X1XXXXX6XGXXXXXXXXX8X9XXXXX4XXX2X9XXXXX7XXXXX1X4X
X762X5172375X62719X9X9X2X5X547X342X1X834X5X95497691131X7X441X32867296952X994X3627342X1X78631X66533X3X
X2XXXXX9X2X6XXXXX6XXXXX3X2X3X7X3XXX1X9XXX3XXX9XXX7XXXXX3X6XXX9XXXXXXX4XXX3XXXXX2XXXXX8X6XXXXX1X1XXXXX
X42476X4X1X9X588X3X133X5X7X1X6X47147X65959X4X4X8X5X517X3X625X83734X474X372X338X545164919786889X2X637X
X2X2XXXXX4XXX8XXX4XXX1X2X7X3XXX4XXX2X9XXX5X8XXX7X4XXX5X6XXXXXXX5XXX3X5XXXXX9XXX4XXXXXXX5X2X2XXXXX9X3X
X8X789X3127865X663X9X613X58458X949X6X3X4X5482579X571765859X9X379X997X5X2X11664X571X8X97147X2X4X7X7X9X
XXX7X3XXXXX3X7X2X2X3X4XXXXX3X2XXXXXXXXX3XXX3X8X9XXXXX2XXXXX5X3XXX8XXXXX2X7XXXXXXXXX3XXX9XXX9X1X4X6XXX
X8X9X35765X2X2X8X525X8757431X4X157X7422155X1X2X548392795824425X364X1X253X185X679X4417721X19724424931X
X2X6X6XXX8X9XXX2XXX6X2X5XXXXX5X8XXXXX4X8X1X8X1X2XXXXXXX4X3X6X8XXX5X2X9XXX6X5XXX5XXX6XXXXX7XXX3XXX7X2X
X881X3X3512832X6X96568X6X4917343X38455X1X629X1X4554153X1X4X5X1X254X3689889X8825568199879X715X956X7X7X
XXXXXXXXXXXXXXXXXXXXXXXXXXXXXXXXXXXXXXXXXXXXXXXXXXXXXXXXXXXXXXXXXXXXXXXXXXXXXXXXXXXXXXXXXXXXXXXXXXXXX
